######################################################################################################################################################################################
#.................................................................................................................#...............................................#..................#
#.................................................................................................................#...............................................#..................#
#.................................................................................................................#...............#...............................#..................#
#.................................................................................................................#...............#...............................#..................#
#.................................................................................................................#...............#...............................#..................#
#.................................................................................................................#...............#...............................#..................#
#........########################.................................................................................#...............#...............................#..................#
#........#......................#.................................................................................#...............#...............................##########...#######
#........#..##################..#.................................................................................................#..................................................#
#........#..#................#..#.................................................................................................#..................................................#
#........#..#................#..#.................................................................................####################################################################
#........#..#######....#######..#....................................................................................................................................................#
#........#......................#....................................................................................................................................................#
#........#......................#....................................................................................................................................................#
#........##########...###########....................................................................................................................................................#
#....................................................................................................................................................................................#
#..................................................................##########........................................................................................................#
#...............................................................################.....................................................................................................#
#.....................................................................############...................................................................................................#
#........................................................####################........................................................................................................#
#................................................................#..........###########..............................................................................................#
#..............................................................################......................................................................................................#
#................................................#....#######################........................................................................................................#
#..............................................###...........############################............................................................................................#
#.............................................#######...............#################................................................................................................#
#..........................................#############......################.......................................................................................................#
#.....................................##########################.....#######.........................................................................................................#
#......................................########################......................................................................................................................#
#........................................########################....................................................................................................................#
#.............................................##################.....................................................................................................................#
#.....................................................#########......................................................................................................................#
#....................................................................................................................................................................................#
#....................................................................................................................................................................................#
#....................................................................................................................................................................................#
#....................................................................................................................................................................................#
######################################################################################################################################################################################


