###############################################################################################################################
#..........................................................#...............................................#..................#
#..........................................................#...............................................#..................#
#..........................................................#...............#...............................#..................#
#..........................................................#...............#...............................#..................#
#..........................................................#...............#...............................#..................#
#..........................................................#...............#...............................#..................#
#........########################..........................#...............#...............................#..................#
#........#......................#..........................#...............#...............................##########...#######
#........#..##################..#..........................................#..................................................#
#........#..#................#..#..........................................#..................................................#
#........#..#................#..#..........................####################################################################
#........#..#######....#######..#.............................................................................................#
#........#......................#.............................................................................................#
#........#......................#.............................................................................................#
#........##########...###########.............................................................................................#
#.............................................................................................................................#
#.............................................................................................................................#
#.............................................................................................................................#
#.............................................................................................................................#
#.............................................................................................................................#
#.............................................................................................................................#
#.............................................................................................................................#
#.............................................................................................................................#
#.............................................................................................................................#
#.............................................................................................................................#
#.............................................................................................................................#
#.............................................................................................................................#
#.............................................................................................................................#
###############################################################################################################################


