#############################################################################################################################################################################################################
#........................................................................................................................................#...............................................#..................#
#........................................................................................................................................#...............................................#..................#
#........................................................................................................................................#...............#...............................#..................#
#........................................................................................................................................#...............#...............................#..................#
#........................................................................................................................................#...............#...............................#..................#
#........................................................................................................................................#...............#...............................#..................#
#........########################........................................................................................................#...............#...............................#..................#
#........#......................#........................................................................................................#...............#...............................##########...#######
#........#..##################..#........................................................................................................................#..................................................#
#........#..#................#..#........................................................................................................................#..................................................#
#........#..#................#..#........................................................................................................####################################################################
#........#..#######....#######..#...........................................................................................................................................................................#
#........#......................#...........................................................................................................................................................................#
#........#......................#...........................................................................................................................................................................#
#........##########...###########...........................................................................................................................................................................#
#...........................................................................................................................................................................................................#
#.........................................................................................##########........................................................................................................#
#......................................................................................################.....................................................................................................#
#............................................................................................############...................................................................................................#
#...............................................................................####################........................................................................................................#
#.......................................................................................#..........###########..............................................................................................#
#.....................................................................................################......................................................................................................#
#.......................................................................#....#######################........................................................................................................#
#.....................................................................###...........############################............................................................................................#
#....................................................................#######...............#################................................................................................................#
#.................................................................#############......################.......................................................................................................#
#............................................................##########################.....#######.........................................................................................................#
#.............................................................########################......................................................................................................................#
#...............................................................########################....................................................................................................................#
#....................................................................##################.....................................................................................................................#
#............................................................................#########......................................................................................................................#
#...........................................................................................................................................................................................................#
#...........................................................................................................................................................................................................#
#...........................................................................................................................................................................................................#
#...........................................................................................................................................................................................................#
#...........................................................................................................................................................................................................#
#...........................................................................................................................................................................................................#
#...........................................................................................................................................................................................................#
#...........................................................................................................................................................................................................#
#...........................................................................................................................................................................................................#
#...........................................................................................................................................................................................................#
#...........................................................................................................................................................................................................#
#...........................................................................................................................................................................................................#
#...........................................................................................................................................................................................................#
#...........................................................................................................................................................................................................#
#...........................................................................................................................................................................................................#
#...........................................................................................................................................................................................................#
#...........................................................................................................................................................................................................#
#...........................................................................................................................................................................................................#
#...........................................................................................................................................................................................................#
#...........................................................................................................................................................................................................#
#...........................................................................................................................................................................................................#
#...........................................................................................................................................................................................................#
#...........................................................................................................................................................................................................#
#############################################################################################################################################################################################################


