########################
#......................#
#......................#
#.....P................#
#......................#
#......................#
#.......S..............#
#......K...............#
#......................#
#......................#
#......................#
#......................#
#......................#
#......................#
#......................#
########################
